smiles
20 20
ROTATIONAL
 , , , , , , , , , , , , , , , , , , , ,
 , , , , , , , , , , , , , , , , , , , ,
 , , , , , , ,x, ,x, , , , , , , , , , ,
 , , , , , , , , , , , , , , , , , , , ,
 , , , , , ,x, , , ,x, , , , , , , , , ,
 , , , , , , ,x,x,x, , , , , , , , , , ,
 , , , , , , , , , , , , , , , , , , , ,
 , , , , , , , , , , , , , , , , , , , ,
 , , , , , , , , , , , , , , , , ,x, , ,
 , , , ,x,x,x,x,x,x,x, , , , , ,x, , , ,
 , , ,x, , , , , ,x,x,x,x,x,x,x, , , , ,
 , ,x, , , , , , , , , , , , , , , , , ,
 , , , , , , , , , , , , , , , , , , , ,
 , , , , , , , , , , , , , , , , , , , ,
 , , , , , , , , , ,x,x,x, , , , , , , ,
 , , , , , , , , ,x, , , ,x, , , , , , ,
 , , , , , , , , , , , , , , , , , , , ,
 , , , , , , , , , ,x, ,x, , , , , , , ,
 , , , , , , , , , , , , , , , , , , , ,
 , , , , , , , , , , , , , , , , , , , ,
0,0,0,0,0,0,0,0,0,0,0,0,0,0,0,0,0,0,0,0,
0,0,0,0,0,0,0,0,0,0,0,0,0,0,0,0,0,0,0,0,
0,0,0,0,0,0,0,0,0,0,0,0,0,0,0,0,0,0,0,0,
0,0,0,0,0,0,0,0,100,0,0,0,0,0,0,0,0,0,0,0,
0,0,0,0,0,0,0,0,0,0,0,0,0,0,0,40,0,0,0,0,
0,0,0,0,0,0,0,0,0,0,0,0,0,0,0,0,0,0,0,0,
0,0,0,0,0,0,0,0,0,0,0,0,0,0,0,0,0,0,0,0,
0,0,0,0,40,0,0,0,0,0,0,0,0,0,0,0,0,0,0,0,
0,0,0,0,0,0,0,0,0,40,0,0,0,0,0,0,0,0,0,0,
0,0,0,0,0,0,0,0,0,0,0,0,0,0,0,0,0,0,0,0,
0,0,0,0,0,0,0,0,0,0,0,0,0,0,0,0,0,0,0,0,
0,0,0,0,0,0,0,0,0,0,40,0,0,0,0,0,0,0,0,0,
0,0,0,0,0,0,0,0,0,0,0,0,0,0,0,40,0,0,0,0,
0,0,0,0,0,0,0,0,0,0,0,0,0,0,0,0,0,0,0,0,
0,0,0,0,0,0,0,0,0,0,0,0,0,0,0,0,0,0,0,0,
0,0,0,0,40,0,0,0,0,0,0,0,0,0,0,0,0,0,0,0,
0,0,0,0,0,0,0,0,0,0,0,100,0,0,0,0,0,0,0,0,
0,0,0,0,0,0,0,0,0,0,0,0,0,0,0,0,0,0,0,0,
0,0,0,0,0,0,0,0,0,0,0,0,0,0,0,0,0,0,0,0,
0,0,0,0,0,0,0,0,0,0,0,0,0,0,0,0,0,0,0,0,
1 2
7 11
