C:/Users/ryana/OneDrive/Desktop/VSCodeWorkspace/NotBattlecode/maps/test3.txt
60 20
HORIZONTAL
 , , , , , , , , , , , , , , , , , , , ,
 , , , , , , , , , , , , , , , , , , , ,
 , , , , , , , , , , , , , , , , , , , ,
 , , , , , , , , , , , , , , , , , , , ,
 , , , , , , , , , , , , , , , , , , , ,
 , , , , , , , , , , , , , , , , , , , ,
 , , , , , , , , , , , , , , , , , , , ,
 , , , , , , , , , , , , , , , , , , , ,
 , , , , , , , , , , , , , , , , , , , ,
 , ,x,x,x, , , , , , , , , , ,x,x,x, , ,
 , , , , ,x, , , , , , , , ,x, , , , , ,
 , , , , , ,x, , , , , , ,x, , , , , , ,
 , , , , , , ,x, , , , ,x, , , , , , , ,
 , , , , , , , ,x, , ,x, , , , , , , , ,
 , , , , , , , , ,x,x, , , , , , , , , ,
 , , , , , , , , ,x,x, , , , , , , , , ,
 , , , , , , , , ,x,x, , , , , , , , , ,
 , , , , , , , , ,x,x, , , , , , , , , ,
 , , , , , , , , ,x,x, , , , , , , , , ,
 , , , , , , , , ,x,x, , , , , , , , , ,
 , , , , , , , , ,x,x, , , , , , , , , ,
 , , , , , , , , ,x,x, , , , , , , , , ,
 , , , , , , , , ,x,x, , , , , , , , , ,
 , , , , , , , , ,x,x, , , , , , , , , ,
 , , , , , , , , ,x,x, , , , , , , , , ,
 , , , , , , , , ,x,x, , , , , , , , , ,
 , , , , , , , , ,x,x, , , , , , , , , ,
 , , , , , , , , , , , , , , , , , , , ,
 , , , , , , , , , , , , , , , , , , , ,
 , , ,x, ,x, , , , , , , , ,x, ,x, , , ,
 , , , , , , , , , , , , , , , , , , , ,
 , , , , , , , ,x, , ,x, , , , , , , , ,
 , , , , , , , , , , , , , , , , , , , ,
 , , , , , , , , , , , , , , , , , , , ,
 , , , , , , , , , , , , , , , , , , , ,
 , , , , , , , , , , , , , , , , , , , ,
 , , , ,x,x,x,x,x,x,x,x,x,x,x,x, , , , ,
 , , , , , , , , ,x,x, , , , , , , , , ,
 , , , , , , , , ,x,x, , , , , , , , , ,
 , , , , , , , , ,x,x, , , , , , , , , ,
 , , , , , , , , ,x,x, , , , , , , , , ,
 , , , , , , , , ,x,x, , , , , , , , , ,
 , , , , , , , , ,x,x, , , , , , , , , ,
 , , , , , , , , ,x,x, , , , , , , , , ,
 , , , , , , , , ,x,x, , , , , , , , , ,
 , , , , , , , , ,x,x, , , , , , , , , ,
 , , , , , , , , ,x,x, , , , , , , , , ,
 , , , , , , , , ,x,x, , , , , , , , , ,
 , , , , , , , , ,x,x, , , , , , , , , ,
 , , , , , , , , , , , , , , , , , , , ,
 , , , , , , , , , , , , , , , , , , , ,
 , , , , , , , , , , , , , , , , , , , ,
 , , , , , , , , , , , , , , , , , , , ,
 , , , , , , , , , , , , , , , , , , , ,
 , , , , , , , , , , , , , , , , , , , ,
 , , , , , , , , , , , , , , , , , , , ,
 , , , , , , , , , , , , , , , , , , , ,
 , , , , , , , , , , , , , , , , , , , ,
 , , , , , , , , , , , , , , , , , , , ,
 , , , , , , , , , , , , , , , , , , , ,
0,0,0,0,0,0,0,0,0,0,0,0,0,0,0,0,0,0,0,0,
0,0,0,0,0,0,0,0,0,0,0,0,0,0,0,0,0,0,0,0,
0,0,0,0,0,0,0,0,0,0,0,0,0,0,0,0,0,0,0,0,
0,0,0,0,0,0,0,0,0,0,0,0,0,0,0,0,0,0,0,0,
0,0,0,0,0,0,0,0,0,0,0,0,0,0,0,0,0,0,0,0,
0,0,0,0,0,0,0,0,0,0,0,0,0,0,0,0,0,0,0,0,
0,0,0,0,0,0,0,0,0,0,0,0,0,0,0,0,0,0,0,0,
0,0,0,0,0,0,0,0,0,0,0,0,0,0,0,0,0,0,0,0,
0,0,0,0,0,0,0,0,0,100,100,0,0,0,0,0,0,0,0,0,
0,0,0,0,0,0,0,0,0,100,100,0,0,0,0,0,0,0,0,0,
0,0,0,0,0,0,0,0,0,100,100,0,0,0,0,0,0,0,0,0,
0,0,0,0,0,0,0,0,0,0,0,0,0,0,0,0,0,0,0,0,
0,0,0,0,0,0,0,0,0,0,0,0,0,0,0,0,0,0,0,0,
0,0,0,0,0,0,0,0,0,0,0,0,0,0,0,0,0,0,0,0,
0,0,0,0,0,0,0,0,0,0,0,0,0,0,0,0,0,0,0,0,
0,0,0,0,0,0,0,0,0,0,0,0,0,0,0,0,0,0,0,0,
0,0,0,0,0,0,0,0,0,0,0,0,0,0,0,0,0,0,0,0,
0,0,0,0,0,0,0,0,0,0,0,0,0,0,0,0,0,0,0,0,
0,0,0,0,0,0,0,0,0,0,0,0,0,0,0,0,0,0,0,0,
0,0,0,0,0,0,0,0,0,0,0,0,0,0,0,0,0,0,0,0,
0,0,0,0,0,0,0,0,0,0,0,0,0,0,0,0,0,0,0,0,
0,0,0,0,0,0,0,0,0,0,0,0,0,0,0,0,0,0,0,0,
0,0,0,0,0,0,0,0,0,0,0,0,0,0,0,0,0,0,0,0,
0,0,0,0,0,0,0,0,0,0,0,0,0,0,0,0,0,0,0,0,
0,0,0,0,0,0,0,0,0,0,0,0,0,0,0,0,0,0,0,0,
0,0,0,0,0,0,0,0,0,0,0,0,0,0,0,0,0,0,0,0,
0,0,0,0,0,0,0,0,0,0,0,0,0,0,0,0,0,0,0,0,
0,0,0,0,0,0,0,0,0,0,0,0,0,0,0,0,0,0,0,0,
0,0,0,0,0,0,0,0,0,0,0,0,0,0,0,0,0,0,0,0,
0,0,0,0,0,0,0,0,0,0,0,0,0,0,0,0,0,0,0,0,
0,0,0,0,0,0,0,0,0,0,0,0,0,0,0,0,0,0,0,0,
0,0,0,0,0,0,0,0,0,0,0,0,0,0,0,0,0,0,0,0,
0,0,0,0,0,0,0,0,0,0,0,0,0,0,0,0,0,0,0,0,
0,0,0,0,0,0,0,0,0,0,0,0,0,0,0,0,0,0,0,0,
0,0,0,0,0,0,0,0,0,0,0,0,0,0,0,0,0,0,0,0,
0,0,0,0,0,0,0,0,0,0,0,0,0,0,0,0,0,0,0,0,
0,0,0,0,0,0,0,0,0,0,0,0,0,0,0,0,0,0,0,0,
0,0,0,0,0,0,0,0,0,0,0,0,0,0,0,0,0,0,0,0,
0,0,0,0,0,0,0,0,0,0,0,0,0,0,0,0,0,0,0,0,
0,0,0,0,0,0,0,0,0,0,0,0,0,0,0,0,0,0,0,0,
0,0,0,0,0,0,0,0,0,0,0,0,0,0,0,0,0,0,0,0,
0,0,0,0,0,0,0,0,0,0,0,0,0,0,0,0,0,0,0,0,
0,0,0,0,0,0,0,0,0,0,0,0,0,0,0,0,0,0,0,0,
0,0,0,0,0,0,0,0,0,0,0,0,0,0,0,0,0,0,0,0,
0,0,0,0,0,0,0,0,0,0,0,0,0,0,0,0,0,0,0,0,
0,0,0,0,0,0,0,0,0,0,0,0,0,0,0,0,0,0,0,0,
0,0,0,0,0,0,0,0,0,0,0,0,0,0,0,0,0,0,0,0,
0,0,0,0,0,0,0,0,0,0,0,0,0,0,0,0,0,0,0,0,
0,0,0,0,0,0,0,0,0,0,0,0,0,0,0,0,0,0,0,0,
0,0,0,0,0,0,0,0,0,0,0,0,0,0,0,0,0,0,0,0,
0,0,40,0,0,0,0,0,0,0,0,0,0,0,0,0,0,40,0,0,
0,0,0,0,0,0,0,0,0,0,0,0,0,0,0,0,0,0,0,0,
0,0,0,0,0,0,0,0,0,0,0,0,0,0,0,0,0,0,0,0,
0,0,0,0,0,0,40,0,0,0,0,0,0,40,0,0,0,0,0,0,
0,0,0,0,0,0,0,0,0,0,0,0,0,0,0,0,0,0,0,0,
0,0,0,0,0,0,0,0,0,0,0,0,0,0,0,0,0,0,0,0,
0,0,0,0,0,0,0,0,0,0,0,0,0,0,0,0,0,0,0,0,
0,0,0,0,0,0,0,0,40,0,0,40,0,0,0,0,0,0,0,0,
0,0,0,0,0,0,0,0,0,0,0,0,0,0,0,0,0,0,0,0,
0,0,0,0,0,0,0,0,0,0,0,0,0,0,0,0,0,0,0,0,
4 21
6 40
